afmælisveisla	noun
anddyri	noun
aðalhlutverk	noun
belti	noun
birta	noun
blaðagrein	noun
borg	noun
borð	noun
bróðir	noun
bíll	noun
bíó	noun
bíómynd	noun
bók	noun
bókmenntafræði	noun
dagblað	noun
dagur	noun
dalur	noun
diskur	noun
dót	noun
eignarfall	noun
fangelsi	noun
farangur	noun
ferð	noun
fjall	noun
forrit	noun
forritari	noun
framtíð	noun
frelsishetja	noun
gaman	noun
gangstétt	noun
gata	noun
geisladiskur	noun
grein	noun
greiða	noun
gönguferð	noun
handklæði	noun
handrit	noun
hangikjöt	noun
haust	noun
herbergi	noun
hestur	noun
hlutur	noun
hlutverk	noun
hreinleiki	noun
hálstafla	noun
hár	noun
hárþurrka	noun
hörkuvinna	noun
hús	noun
innsetning	noun
kennari	noun
kongur	noun
kort	noun
króna	noun
kvikmynd	noun
kvöldmatur	noun
kyrrð	noun
kóramót	noun
leikstjóri	noun
leiðsögumaður	noun
listamaður	noun
listasafn	noun
listaverk	noun
listfræðingur	noun
litur	noun
líf	noun
lýsingarorð	noun
mappa	noun
matur	noun
maður	noun
meistari	noun
mikill	noun
miðbær	noun
miði	noun
mynd	noun
málverk	noun
mót	noun
nafnorð	noun
nammi	noun
nefnifall	noun
nemandi	noun
nóta	noun
ostur	noun
persóna	noun
peysa	noun
piltur	noun
popp	noun
pottur	noun
rós	noun
rúm	noun
rúta	noun
safn	noun
sagnorð	noun
samband	noun
samloka	noun
samúð	noun
sjampó	noun
skinka	noun
skógur	noun
skór	noun
sonur	noun
spjall	noun
steinn	noun
stelpa	noun
stjórnandi	noun
stjórnmálamaður	noun
strákur	noun
stytta	noun
stærðfræði	noun
stóll	noun
sumar	noun
sundbolur	noun
sundföt	noun
sundgleraugu	noun
sundskýla	noun
svefnpoki	noun
svæði	noun
systkini	noun
sápa	noun
sími	noun
sólarolía	noun
sólbekkur	noun
söguþráður	noun
söngkona	noun
söngvari	noun
súpa	noun
taska	noun
torg	noun
tækifæri	noun
tónlist	noun
tónlistarmaður	noun
tölva	noun
tölvupóstur	noun
undantekning	noun
upplýsing	noun
uppáhald	noun
vatn	noun
vefsíða	noun
veitingahús	noun
veitingastaður	noun
verkefni	noun
verðlaun	noun
vetur	noun
vina	noun
vinur	noun
vor	noun
vél	noun
á	noun
áhorfandi	noun
æfing	noun
öld	noun
þjóðlistasafn	noun
þjóðminjasafn	noun
þolfall	noun
þágufall	noun
alþjóðlegur	adjective
appelsínugulur	adjective
auðveldur	adjective
bjartur	adjective
bleikur	adjective
blár	adjective
brúnn	adjective
dapur	adjective
dimmur	adjective
duglegur	adjective
erfiður	adjective
fallegur	adjective
fjólublár	adjective
fjölbreyttur	adjective
flestur	adjective
frekur	adjective
frábær	adjective
frægur	adjective
fróður	adjective
fyndinn	adjective
félagslyndur	adjective
gamall	adjective
glaður	adjective
glæsilegur	adjective
grár	adjective
grænn	adjective
gulur	adjective
gáfaður	adjective
hamingjusamur	adjective
heimsfrægur	adjective
heimskur	adjective
heitur	adjective
hlýr	adjective
hreinn	adjective
hress	adjective
hvítur	adjective
hæfileikaríkur	adjective
hægur	adjective
kaldur	adjective
kveðinn	adjective
kvíðinn	adjective
kátur	adjective
latur	adjective
leiðinlegur	adjective
ljótur	adjective
léttur	adjective
lítill	adjective
margur	adjective
nógur	adjective
nýlegur	adjective
nýr	adjective
rauður	adjective
rólegur	adjective
saddur	adjective
skemmtilegur	adjective
skýr	adjective
sorglegur	adjective
spennandi	adjective
spenntur	adjective
stórkostlegur	adjective
svangur	adjective
svartur	adjective
svolítill	adjective
sérstakur	adjective
tilbúinn	adjective
ungur	adjective
vinsæll	adjective
vondur	adjective
yndislegur	adjective
áhugasamur	adjective
ánægjulegur	adjective
ótrúlegur	adjective
óvinsæll	adjective
óþekktur	adjective
örugglega	adjective
þreyttur	adjective
þröngur	adjective
þunglyndur	adjective
þyrstur	adjective
